Congratulations. you are now the district safety martial for Shady Oaks retirement district. This is where people put there old people when they don't want them anymore. Seeing as you are the only competent individual on the block, you got stuck with the job. However, not everyone is happy with this situation. Schnitzel, your crazy neighbor from across the stream, is furious. He really wanted that job apparently. In retaliation, he has used his retirement fund to build several automated potato launchers in a field next to his house. You are currently cowering under your porch. Your house and all of the houses surrounding Mr. Schnitzel's, are all being bombarded by flying potatoes. In the midst of the spudtacular air raid find a way out of here and get rid of those potato launchers. Move forward and stop Schnitzel's mad plan for neighborhood domination.

Das Mine Field
An Interactive Fiction by Ty Shimabukuro
Release 1 / Serial number 141028 / Inform 7 build 6L38 (I6/v6.33 lib 6/12N) SD

Your porch
This is your dinky wooden porch. Due to the veranda, it was the only part of your house that was safe from the raining potatoes. You ran here as soon as the spuds went flying. A vase full of umbrellas sits by the door. Your yard is to the west.

I beg your pardon?

>w
yard
This is your yard, located directly across the stream from Mr. Schnitzel's  field. It is currently littered with potatoes. Your porch is to the east, the street is to the south and Mr. Angl's yard is to the west.

You can see a potato here.

>take potato
Taken.

>take potato
You already have that.

>take another potatoe
You can't see any such thing.

>take another potato
You already have that.

>eat potato
That's plainly inedible.

* * *

I beg your pardon?

I beg your pardon?

* * *

>take umbrella
Taken.

>w
backyard
This is your yard, located directly across the brooke from Mr. Schnitzel's  field. It is currently littered with potatoes. Your porch is to the east, the street is to the south and Mr. Angl's yard is to the west.

You can see a potatoe here.

>x potatoes
You see nothing special about the potatoes.

>x potatoe
You can't see any such thing.

>x potato
You can't see any such thing.

* * *

>w
backyard
This is your yard, located directly across the brooke from Mr. Schnitzel's  field. It is currently littered with potatoes. Your porch is to the east, the street is to the south and Mr. Angl's yard is to the west.

You can see a potatoe here.

>s
street
This street heads west to the park, north to the backyard, and northwest to the bridge.

You can see a stepladder here.

>w
park
A huge tree takes up the south end of the park. Many things have been lost in said tree. The crazy cat lady loves comes here on her off time.

On the tree is a locket.

>shake tree
You give the tree a good shake ... and the locket swings forward and plummets! Fortunately, you're able to catch it just before it hits the floor.

>e
street
This street heads west to the park, north to the backyard, and northwest to the bridge.

You can see a stepladder here.

>nw
bridge
This bridge crosses the stream by your house. You are next to enemy territory. Mr. Schnitzel's house is to the east, the crazy cat lady's house is to the North East, and the street is to the south.

>ne
crazy cat lady's house
The house of the crazy cat lady. *Cue Lightning* The door was unlocked, so you headed inside. It's messy in here. The the bridge is to the southwest and the Das Mine Field is to the south.

Creeping out of the shadows the crazy cat lady appears.

You can also see a backdoor and Cats here.

* * *

>w
backyard
This is your yard, located directly across the brooke from Mr. Schnitzel's  field. It is currently littered with potatoes. Your porch is to the east, the street is to the south and Mr. Angl's yard is to the west.

You can see a potatoe here.

>x potato
You see nothing special about the potato.

>eat potato
That's plainly inedible.

>x brooke
The water gurgles down.

* * *

>take umbrella
Taken.

>x veranda
This veranda is the only thing between your head and a proper mashing.

>l
Your porch
This is your dinky wooden porch. Due to the veranda, it was the only part of your house that was safe from the raining potatoes. You ran here as soon as the spuds went flying. A vase full of umbrellas sits by the door. Your yard is to the west.

>w
backyard
This is your yard, located directly across the stream from Mr. Schnitzel's  field. It is currently littered with potatoes. Your porch is to the east, the street is to the south and Mr. Angl's yard is to the west.

You can see a potatoes here.

>x potatoes
You see nothing special about the potatoes.

>take potatoes
Taken.

>x potatoes
You see nothing special about the potatoes.

I beg your pardon?

>x potatoe
You can't see any such thing.

>x potatoes
You see nothing special about the potatoes.

* * *

>x porch
You can't see any such thing.

>x veranda
You can't see any such thing.

>x vase
A pretty vase full of umbrellas.

In the vase is an umbrella.

>x umbrellas
You can't see any such thing.

>take umbrella
Taken.

>l
Your porch
This is your dinky wooden porch. Due to the veranda, it was the only part of your house that was safe from the raining potatoes. You ran here as soon as the spuds went flying. A vase full of umbrellas sits by the door. Your yard is to the west.

>i
You are carrying:
  an umbrella

>w
backyard
This is your yard, located directly across the stream from Mr. Schnitzel's  field. It is currently littered with potatoes. Your porch is to the east, the street is to the south and Mr. Angl's yard is to the west.

>e
Your porch
This is your dinky wooden porch. Due to the veranda, it was the only part of your house that was safe from the raining potatoes. You ran here as soon as the spuds went flying. A vase full of umbrellas sits by the door. Your yard is to the west.

>drop umbrella
Dropped.

>w
Are you sure? There are too many potatoes. I don't think you can make it.

>take umbrella
Please answer yes or no.

>yes
    *** A potato mashes into your face. ***

Would you like to RESTART, RESTORE a saved game, QUIT or UNDO the last command?

>undo
Your porch
[Previous turn undone.]

>no
That was a rhetorical question.

>take umbrella
Taken.

>w
backyard
This is your yard, located directly across the stream from Mr. Schnitzel's  field. It is currently littered with potatoes. Your porch is to the east, the street is to the south and Mr. Angl's yard is to the west.

>x potatoes
You can't see any such thing.

>take potatoes
You can't see any such thing.

>x potatoe
You can't see any such thing.

>take potato
You can't see any such thing.

>take potatoe
You can't see any such thing.

>x stream
You can't see any such thing.

>s
street
This street heads west to the park and north to the bridge.

You can see a stepladder here.

>x stepladder
Who throws out a stepladder? These things never break.

>take stepladder
Taken.

>w
park
A huge tree takes up the south end of the park. Many things have been lost in said tree. The crazy cat lady loves comes here on her off time.

On the tree is a locket.

>x locket
This must be the crazy cat lady's fabled locket. I wonder if she actually threw cats at it? She might give you something nice in return for this.

>take locket
You can't reach the locket, as the tree is too high.

>x crazy cat lady
You can't see any such thing.

>x tree
This tree is shockingly tall, but it is also extremely thin and wobbles if you rock it. You see an object stuck on a high branch. Local legend has it that the crazy cat lady throws cats up into the tree to try knock something out of it. She has a very good throwing arm.

On the tree is a locket.

>l
park
A huge tree takes up the south end of the park. Many things have been lost in said tree. The crazy cat lady loves comes here on her off time.

On the tree is a locket.

>n
You can't go that way.

>w
You can't go that way.

>e
street
This street heads west to the park and north to the bridge.

>n
backyard
This is your yard, located directly across the stream from Mr. Schnitzel's  field. It is currently littered with potatoes. Your porch is to the east, the street is to the south and Mr. Angl's yard is to the west.

>s
street
This street heads west to the park and north to the bridge.

>w
park
A huge tree takes up the south end of the park. Many things have been lost in said tree. The crazy cat lady loves comes here on her off time.

On the tree is a locket.

>x tree
This tree is shockingly tall, but it is also extremely thin and wobbles if you rock it. You see an object stuck on a high branch. Local legend has it that the crazy cat lady throws cats up into the tree to try knock something out of it. She has a very good throwing arm.

On the tree is a locket.

>w
You can't go that way.

I beg your pardon?

>e
street
This street heads west to the park and north to the bridge.

* * *

>n
backyard
This is your yard, located directly across the stream from Mr. Schnitzel's  field. It is currently littered with potatoes. Your porch is to the east, the street is to the south and Mr. Angl's yard is to the west.

>northwest
You can't go that way.

>nw
You can't go that way.

>s
street
This street heads west to the park and north to the bridge.

>northwest
bridge
This bridge crosses the stream by your house. You are next to enemy territory. A stream flows underneath. Mr. Schnitzel's house is to the east, the crazy cat lady's house is to the North East, and the street is to the south.

>ne
crazy cat lady's house
The house of the crazy cat lady. *Cue Lightning* The door was unlocked, so you headed inside. It's messy in here. The crazy cat lady is nowhere to be seen She might be elsewhere in the house. You'd better not make any loud noises lest you summon her and incur her wrath.

Creeping out of the shadows the crazy cat lady appears.

You can also see Cats here.

>x cats
There are so many cats. You can't even count them all. Let's see 1,2,3... stop wasting time.

>x crazy cat lady
The crazy cat lady, the most feared creature in the neighborhood. You are not sure if you can trust her.

>talk to crazy cat lady
Vat do you vant?!.

>ask about locket
You can't see any such thing.

>ask crazy cat lady about locket
What locket?! I have not locket?! Locket is still stuck on tree! Stay away from locket, it is mine!.

>s
Das Mine Field
Schnitzel's field. A worn out sign reading Das Mine Field hangs on the fence. Legend has it that back when he was younger, Mr. Schnitzel hid dozens of landmines on the field for no apparent reason. The slightest of electric shocks coud set them off. The three potato launchers are facing towards your house, Angls, and the cat lady's unmanned.

You can see a backdoor here.

>n
crazy cat lady's house
The house of the crazy cat lady. *Cue Lightning* The door was unlocked, so you headed inside. It's messy in here. The crazy cat lady is nowhere to be seen She might be elsewhere in the house. You'd better not make any loud noises lest you summon her and incur her wrath.

Creeping out of the shadows the crazy cat lady appears.

You can also see Cats here.

>w
You can't go that way.

>e
You can't go that way.

>sw
bridge
This bridge crosses the stream by your house. You are next to enemy territory. A stream flows underneath. Mr. Schnitzel's house is to the east, the crazy cat lady's house is to the North East, and the street is to the south.

>e
Schnitzel's house
Mr. Schnitzel's house, the citidel of evil. It smells of potatoes and death. Mr. Schnitzel is pacing around muttering to himself whilst holding a potato gun. You should probably leave before he notices you. The bridge is to the west.

Schnitzel is taking a break at a table drinking coffee.

>x schnitzel
You can't see any such thing.

>x table
You can't see any such thing.

>x coffee
You can't see any such thing.

>s
You can't go that way.

>w
bridge
This bridge crosses the stream by your house. You are next to enemy territory. A stream flows underneath. Mr. Schnitzel's house is to the east, the crazy cat lady's house is to the North East, and the street is to the south.

>ne
crazy cat lady's house
The house of the crazy cat lady. *Cue Lightning* The door was unlocked, so you headed inside. It's messy in here. The crazy cat lady is nowhere to be seen She might be elsewhere in the house. You'd better not make any loud noises lest you summon her and incur her wrath.

Creeping out of the shadows the crazy cat lady appears.

You can also see Cats here.

>take cats
You don't want the cat.

>take cat
I don't suppose the crazy cat lady would care for that.

>i
You are carrying:
  a stepladder
  an umbrella

>sw
bridge
This bridge crosses the stream by your house. You are next to enemy territory. A stream flows underneath. Mr. Schnitzel's house is to the east, the crazy cat lady's house is to the North East, and the street is to the south.

>x stream
The water makes a serene babbling sound below. You used to play down by the river as a kid.

>down
river
This river is a hidden little shortcut between the bridge, Das Mine field and your backyard. The river is below the bridge. The river is south of Das Mine Field and North of the backyard.

>n
Das Mine Field
Schnitzel's field. A worn out sign reading Das Mine Field hangs on the fence. Legend has it that back when he was younger, Mr. Schnitzel hid dozens of landmines on the field for no apparent reason. The slightest of electric shocks coud set them off. The three potato launchers are facing towards your house, Angls, and the cat lady's unmanned.

You can see a backdoor here.

>s
river
This river is a hidden little shortcut between the bridge, Das Mine field and your backyard. The river is below the bridge. The river is south of Das Mine Field and North of the backyard.

>s
You can't go that way.

>se
You can't go that way.

>sw
You can't go that way.

I beg your pardon?

>l
river
This river is a hidden little shortcut between the bridge, Das Mine field and your backyard. The river is below the bridge. The river is south of Das Mine Field and North of the backyard.

>w
You can't go that way.

* * *

>x umbrellas
You can't see any such thing.

>x vase
You can't see any such thing.

* * *

>x veranda
This veranda is the only thing between your head and a proper mashing.

>x vase
A pretty vase full of umbrellas.

In the vase is an umbrella.

>x umbrella
You see nothing special about the umbrella.

>take umbrella
Taken.

* * *

>w
backyard
This is your yard, located directly across the brooke from Mr. Schnitzel's  field. It is currently littered with potatoes. Your porch is to the east, the street is to the south and Mr. Angl's yard is to the west.

You can see a potatoe here.

I beg your pardon?

>n
You can't go that way.

>nw
river
This river is a hidden little shortcut between the bridge, Das Mine field and your backyard. The river is below the bridge. The river is south of Das Mine Field and Northwest of the backyard.

>se
backyard
This is your yard, located directly across the brooke from Mr. Schnitzel's  field. It is currently littered with potatoes. Your porch is to the east, the street is to the south and Mr. Angl's yard is to the west.

You can see a potatoe here.

>take potatoe
Taken.

>x potatoe
This potato did not splat on impact. It is defective to not have splated. It is worthless.

>w
Angl's yard
Angl's yard and house are also covered in potatoes. Casualties of war. You can hear him silently muttering to himself from a safe spot on the second floor.

Angl is hiding by his windowsill. He doesn't look to pleased with all of the flying potatoes in the air.

>x windowsill
Angl is hiding nearby. He's muttering a steady stream of words with an angry intonation.

>x angl
Angl is your friendly British neighbor. He thinks he's a spy and has a fondness for his pet pigeon.

>talk to angl
Oi, neighbor its raining spuds out here innit? You mind giving a fellow a hand? Could you look for a pidgeon while shouting pretty bird around the neighborhood? I'll give ya something that you'll love.

>yell pretty bird
The bird must not be here.

>e
backyard
This is your yard, located directly across the brooke from Mr. Schnitzel's  field. It is currently littered with potatoes. Your porch is to the east, the street is to the south and Mr. Angl's yard is to the west.

>s
street
This street heads west to the park, north to the backyard, and northwest to the bridge.

You can see a stepladder here.

>x stepladder
Who throws out a stepladder? These things never break. It's about four feet tall.

>take stepladder
Taken.

* * *

>w
park
A huge tree takes up the south end of the park. Many things have been lost in said tree. The crazy cat lady loves comes here on her off time.

On the tree is a locket.

>take locket
You can't reach the locket, as the tree is too high.

>take all
locket: You can't reach the locket, as the tree is too high.

>pretty bird
A pidgeon flew up to you and started cooing happily.

>take pidgeon
I don't suppose Pidgeon would care for that.

>i
You are carrying:
  Pidgeon
  a stepladder
  a potatoe
  an umbrella

>talk to pidgeon
Pidgeon doesn't reply.

>e
street
This street heads west to the park, north to the backyard, and northwest to the bridge.

>n
backyard
This is your yard, located directly across the brooke from Mr. Schnitzel's  field. It is currently littered with potatoes. Your porch is to the east, the street is to the south and Mr. Angl's yard is to the west.

>w
Angl's yard
Angl's yard and house are also covered in potatoes. Casualties of war. You can hear him silently muttering to himself from a safe spot on the second floor.

Angl is hiding by his windowsill. He doesn't look to pleased with all of the flying potatoes in the air.

>give pidgeon to angl
As promised, here take this. If you stick it onto the potato you got there, into explode. One big kerbloey I tell you wot mate.

I beg your pardon?

>i
You are carrying:
  a strange device
  a stepladder
  a potatoe
  an umbrella

>s
You can't go that way.

>w
You can't go that way.

>l
Angl's yard
Angl's yard and house are also covered in potatoes. Casualties of war. You can hear him silently muttering to himself from a safe spot on the second floor.

Angl is hiding by his windowsill. He doesn't look to pleased with all of the flying potatoes in the air.

>e
backyard
This is your yard, located directly across the brooke from Mr. Schnitzel's  field. It is currently littered with potatoes. Your porch is to the east, the street is to the south and Mr. Angl's yard is to the west.

>s
street
This street heads west to the park, north to the backyard, and northwest to the bridge.

>nw
bridge
This bridge crosses the stream by your house. You are next to enemy territory. Mr. Schnitzel's house is to the east, the crazy cat lady's house is to the North East, and the street is to the south.

I beg your pardon?

>x stream
The water makes a serene babbling sound below. You used to play down by the river as a kid.

>ne
crazy cat lady's house
The house of the crazy cat lady. *Cue Lightning* The door was unlocked, so you headed inside. It's messy in here. The the bridge is to the southwest and the Das Mine Field is to the south.

Creeping out of the shadows the crazy cat lady appears.

You can also see a backdoor and Cats here.

>x backdoor
You see nothing special about the backdoor.

>x cats
There are so many cats. You can't even count them all. Let's see 1,2,3... stop wasting time.

>take cats
You don't want the cat.

>pet cat
That's not a verb I recognise.

>eat cat
He's plainly inedible.

>x crazy cat lady
The crazy cat lady, the most feared creature in the neighborhood. You are not sure if you can trust her.

* * *

>ask about locket
You can't see any such thing.

>ask crazy cat lady about locket
What locket?! I have not locket?! Locket is still stuck on tree! Stay away from locket, it is mine! Just because I am to frail to shake tree!.

>ask crazy cat lady about cats
Cats is good, yes. Yes cats is good for everything, yes?

>take all
There are none at all available!

>l
crazy cat lady's house
The house of the crazy cat lady. *Cue Lightning* The door was unlocked, so you headed inside. It's messy in here. The the bridge is to the southwest and the Das Mine Field is to the south.

Creeping out of the shadows the crazy cat lady appears.

You can also see a backdoor and Cats here.

>sw
bridge
This bridge crosses the stream by your house. You are next to enemy territory. Mr. Schnitzel's house is to the east, the crazy cat lady's house is to the North East, and the street is to the south.

>e
Schnitzel's house
Mr. Schnitzel's house, the citidel of evil. It smells of potatoes and death. Mr. Schnitzel is pacing around muttering to himself whilst holding a potato gun. You should probably leave before he notices you. The bridge is to the west.

Schnitzel is taking a break at a table drinking coffee.

>x schnitzel
Grumpy old Mr. Schnitzel. He's muttering in to himself in German. Armed with a potato gun, he looks like he wants to shoot something.

>x potato gun
A custom gun made to fire potatoes. Actual fire arms are not allowed on the property.

>x coffee
Mr. Schnitzel's coffee. It's very black.

>talk to schnitzel
Schnitzel doesn't reply.

    *** Oh no, Mr. Schnitzel noticed you. He's approaching you brandishing his potato gun. ***

Would you like to RESTART, RESTORE a saved game, QUIT or UNDO the last command?

>undo
Schnitzel's house
[Previous turn undone.]

>w
bridge
This bridge crosses the stream by your house. You are next to enemy territory. Mr. Schnitzel's house is to the east, the crazy cat lady's house is to the North East, and the street is to the south.

>s
You can't go that way.

>sw
You can't go that way.

>se
street
This street heads west to the park, north to the backyard, and northwest to the bridge.

>w
park
A huge tree takes up the south end of the park. Many things have been lost in said tree. The crazy cat lady loves comes here on her off time.

On the tree is a locket.

>x tree
This tree is shockingly tall, but it is also extremely thin and wobbles if you rock it. Local legend has it that the crazy cat lady throws cats up into the tree to try shake something out of it. She has a very good throwing arm.

On the tree is a locket.

>shake tree
You give the tree a good shake ... and the locket swings forward and plummets! Fortunately, you're able to catch it just before it hits the floor.

>w
You can't go that way.

>e
street
This street heads west to the park, north to the backyard, and northwest to the bridge.

>nw
bridge
This bridge crosses the stream by your house. You are next to enemy territory. Mr. Schnitzel's house is to the east, the crazy cat lady's house is to the North East, and the street is to the south.

* * *

>ne
crazy cat lady's house
The house of the crazy cat lady. *Cue Lightning* The door was unlocked, so you headed inside. It's messy in here. The the bridge is to the southwest and the Das Mine Field is to the south.

Creeping out of the shadows the crazy cat lady appears.

You can also see a backdoor and Cats here.

>give crazy cat lady locket
The cat lady smiles, snatches the locket from you, and walks off. She soon returns and hands you a key.

>s
(first unlocking the backdoor with the rusty key, then opening the door)

Das Mine Field
Schnitzel's field. A worn out sign reading Das Mine Field hangs on the fence. Legend has it that back when he was younger, Mr. Schnitzel hid dozens of landmines on the field for no apparent reason. The slightest of electric shocks coud set them off. The three potato launchers are facing towards your house, Angls, and the cat lady's unmanned. The crazy cat ladies house is to the north.

On the potato launcher is Rubber band.

You can also see a backdoor here.

>x potato launcher
A silent sentry. An automated artillery unit designed with the sole purpose of raining hot spuddy death unto all those who stand in its way. The launching mechanism is powered by a giant rubber band.

On the potato launcher is Rubber band.

>x potato launcher
A silent sentry. An automated artillery unit designed with the sole purpose of raining hot spuddy death unto all those who stand in its way. The launching mechanism is powered by a giant rubber band.

On the potato launcher is Rubber band.

I beg your pardon?

>x potato launcher
A silent sentry. An automated artillery unit designed with the sole purpose of raining hot spuddy death unto all those who stand in its way. The launching mechanism is powered by a giant rubber band.

On the potato launcher is Rubber band.

>take rubber band
Taken.

>s
river
This river is a hidden little shortcut between the bridge, Das Mine field and your backyard. The river is below the bridge. The river is south of Das Mine Field and Northwest of the backyard.

>sw
You can't go that way.

>se
backyard
This is your yard, located directly across the brooke from Mr. Schnitzel's  field. It is currently littered with potatoes. Your porch is to the east, the street is to the south and Mr. Angl's yard is to the west.

I beg your pardon?

>i
You are carrying:
  Rubber band
  a rusty key
  a strange device
  a stepladder
  a potatoe
  an umbrella

>n
You can't go that way.

* * *

>nw
river
This river is a hidden little shortcut between the bridge, Das Mine field and your backyard. The river is below the bridge. The river is south of Das Mine Field and Northwest of the backyard.

>n
Das Mine Field
Schnitzel's field. A worn out sign reading Das Mine Field hangs on the fence. Legend has it that back when he was younger, Mr. Schnitzel hid dozens of landmines on the field for no apparent reason. The slightest of electric shocks coud set them off. The three potato launchers are facing towards your house, Angls, and the cat lady's unmanned. The crazy cat ladies house is to the north.

You can see a backdoor here.

>n
crazy cat lady's house
The house of the crazy cat lady. *Cue Lightning* The door was unlocked, so you headed inside. It's messy in here. The the bridge is to the southwest and the Das Mine Field is to the south.

Creeping out of the shadows the crazy cat lady appears.

You can also see a backdoor and Cats here.

    *** Mr. Schnitzel has finally been stopped. His tuber powered siege machines our out of starch and his retirement fund is out of money. The local pidgeons have started eating the potatoes off of everyone's houses, and the crazy cat lady is still insane. Today was a pretty good day. ***

Would you like to RESTART, RESTORE a saved game, QUIT or UNDO the last command?

>undo
Das Mine Field
[Previous turn undone.]

* * *

>x vase
You can't see any such thing.

* * *

>x vas
You can't see any such thing.

>x vase
You can't see any such thing.

* * *

>w
Are you sure? There are too many potatoes. I don't think you can make it.

* * *

>take all
(the umbrella)
Taken.

>w
backyard
This is your yard, located directly across the brooke from Mr. Schnitzel's  field. It is currently littered with potatoes. Your porch is to the east, the street is to the south and Mr. Angl's yard is to the west.

You can see a potato here.

>x potato
This potato did not splat on impact. It is defective to not have splated. It is worthless.

>take potato
Taken.